looks aren't everything; le physique ça n'est pas tout
she's all skin and bone; elle a la peau sur les os
wow, is she ever stacked!;	bigre, elle est bien roulée!
the jaws; les machoires
the nostrils; les narines
the cheekbones; les pommettes
a diagnosis; un diagnostique
my head is spinning; ma tête tourne
to poo; faire caca
the nape of the neck; la nuque
the navel; le nombril
the spleen; la rate
dark green; vert foncé
light blue; bleu clair
to grow one's hair;se laisser pousser les cheveux
to clench one's fist / teeth;	serrer le poing / les dents
yellowish; jaunatre
hush!; chut!
tall;	grand
stout;	solide, corpulent
a dwarf	;un nain
big;	grand, gros
figure	;la silhouette
to keep one's figure;	garder la ligne
plump	;dodu, potelé
fat	;gras
to put on weight;	prendre du poids
to be, to go on a diet;	suivre un régime
to slim	;maigrir
thin, lean;	maigre
lanky	;grand et maigre
the skeleton;	le squelette
a bone;	un os
a joint	;une articulation
a nerve;	un nerf
a muscle;	un muscle
flesh	;la chair (flesh-eating = carnivore)
skin;	la peau
to make so's flesh creep;	donner la chair de poule
the skull	;le crâne
the brain	;le cerveau
an organ;	un organe
ugly	;laid, repoussant
beauty;	la beauté
pretty;	belle (uniquement pour les femmes)
handsome;	beau (uniquement pour les hommes)
attractive;	séduisant
good-looking;	beau, belle
plain;	quelconque, sans charme
complexion;	le teint
sunburnt, suntanned	;hâlé, bronzé
features	;les traits
the forehead;	le front
a wrinkle	;une ride
the nose;	le nez
cheeks;	les joues (cheeks to cheeks joue contre joue)
ears;	les oreilles
eyes;	les yeux
eyebrows;	les sourcils
eyelashes	;les cils
eyelids;	les paupières
the mouth	;la bouche
a lip	;une lèvre
a tooth, teeth;	une dent, des dents
the tongue;	la langue
the palate;	le palais
a moustache	;une moustache
the chin;	le menton
a beard;	une barbe
the crown of the head	;le sommet de la tête
bald;	chauve
a wig	;une perruque
to make so's hair stand on end;	faire se dresser les cheveux sur la tête
a lock;	une mèche
a curl;	une boucle
wavy;	ondulant
curly	;bouclé
frizzy;	crépu
a blonde;	une blonde
a brunette;	une brune
fair	;blond
dark;	brun
auburn;	châtain clair
red	;roux
redhead	;une rousse
to dye one's hair;	se teindre les cheveux
shampoo;	le shampooing
a hair-dryer;	un sèche-cheveux
the trunk	;le tronc
the back;	le dos
straight;	droit
bent	;voûté
the breast;	la poitrine
the chest	;la cage thoracique
ribs;	les côtes
the backbone, the spine	;la colonne vertébrale
lungs	;les poumons
liver	;le foie
liver boot;	crise de foie
to breathe;	respirer
to stifle;	s'étouffer
to choke;	s'étrangler
the legs;	les jambes
the thigh	;la cuisse
the knee;	le genou
the kneecap	;la rotule
the calf;	le mollet
the ankle	;la cheville
to sprain an ankle;	se fouler la cheville
the toes	;les orteils
the sole;	la plante du pied
the heels	;les talons
to take to one's heels;	prendre ses jambes à son cou
bare	;nu
bare-footed	;nu-pieds
bare-headed	;tête nue
to stand in water ankle deep;	avoir de l'eau jusqu'aux chevilles
to stand in water knee-deep;	avoir de l'eau jusqu'au genou
to stand in water shoulder-high;	avoir de l'eau jusqu'aux épaules
naked	;tout nu
the heart	;le coeur
blood	;le sang
the arteries;	les artères
the veins;	les veines
to beat	;battre
to throb;	palpiter
to bleed	;saigner
the waist;	la taille
slender	;mince, élancé
the hips	;les hanches
the liver	;le foie
the stomach	;l'estomac
the belly	;le ventre, l'abdomen
a limb;	un membre (une branche maîtresse pour un arbre)
the arms	;les bras
to shrug one's shoulders ;	hausser les épaules
the elbow;	le coude
the wrist;	le poignet
fist;	poing
the forearm	;l'avant-bras
the right hand	;la main droite
the left hand	;la main gauche
to be left-handed	;être gaucher
to be right-handed	;être droitier
fingers;	les doigts
the thumb	;le pouce
to trim one's nails	;se couper les ongles
to bite one's nails	;se ronger les ongles
the knuckles	;les articulations des doigts
hiccup;	le hoquet
